Subreddit,Scored,Allowed,Margin,Won,Lost,Tied,Result
49ers,16,24,-8,0,1,0,L
azcardinals,6,24,-18,0,1,0,L
bengals,34,23,11,1,0,0,W
browns,21,21,0,0,0,1,T
buccaneers,48,40,8,1,0,0,W
buffalobills,3,47,-44,0,1,0,L
chargers,28,38,-10,0,1,0,L
chibears,23,24,-1,0,1,0,L
colts,23,34,-11,0,1,0,L
cowboys,8,16,-8,0,1,0,L
denverbroncos,27,24,3,1,0,0,W
detroitlions,17,48,-31,0,1,0,L
eagles,18,12,6,1,0,0,W
falcons,12,18,-6,0,1,0,L
greenbaypackers,24,23,1,1,0,0,W
jaguars,20,15,5,1,0,0,W
kansascitychiefs,38,28,10,1,0,0,W
losangelesrams,33,13,20,1,0,0,W
miamidolphins,20,27,-7,1,0,0,W
minnesotavikings,24,16,8,1,0,0,W
nygiants,15,20,-5,0,1,0,L
nyjets,48,17,31,1,0,0,W
oaklandraiders,13,33,-20,0,1,0,L
panthers,16,8,8,1,0,0,W
patriots,27,20,7,1,0,0,W
ravens,47,3,44,1,0,0,W
redskins,24,6,18,1,0,0,W
saints,40,48,-8,0,1,0,L
seahawks,24,27,-3,0,1,0,L
steelers,21,21,0,0,0,1,T
tennesseetitans,27,20,7,0,1,0,L
texans,20,27,-7,0,1,0,L
